AL_common	antigonish	marine
bea	bear_paw_lake	lake
Boot_L	boot	lake
Boot_S	boot	stream
CL_common	lunenburg	marine
CL_white	lunenburg	white
Constance_L	constance	lake
Constance_S	constance	stream
CP_common	antigonish	marine
cr	crooked_river	stream
cs	oregon_coast_mid	marine
denmark_marine	denmark	marine
Geneva_L	geneva	lake
Geneva_S	geneva	stream
Hadsten	hadsten	lake
japan_pac	japan_pacific	marine
japan_sea	japan_sea	japan_type
Joes_L	joes	lake
Joes_S	joes	stream
Lake_Hald	lake_hald	lake
lit_campbell_marine	lit_campbell	marine
LN_common	brasdor	marine
LQ_B	little_quarry	benthic
LQ_L	little_quarry	limnetic
Mariager	mariager	marine
MH_common	chedabucto	marine
MH_white	chedabucto	white
Misty_L	misty	lake
Misty_S	misty	stream
ms	oregon_coast_north	marine
mud	mud_lake	lake
Pax_B	paxton	benthic
Pax_L	paxton	limnetic
pcr	pony_creek	lake
pl	paulina_lake	lake
Pri_B	priest	benthic
Pri_L	priest	limnetic
rab	rabbit_slough	marine
rb	riverbend	stream
res	resurrection_bay	marine
Roberts_L	roberts	lake
Roberts_S	roberts	stream
sj	oregon_coast_mid	marine
SK_common	brasdor	marine
SR_common	chedabucto	marine
SR_white	chedabucto	white
stl	south_twin_lake	lake
wc	winchester	stream
